########
#......#
#......#
#......#
#......#
x..T...#
x......#
#xx#####
