########
#......#
#......#
#......Q
#......Q
x......#
x......#
########
