################
######....######
#####......#####
####S......S####
#I............I#
#..............#
#..............#
######TTTT######
#..............#
#..............#
#..............#
#I............I#
####S......S####
#####......#####
######....######
#######xx#######
