#######xx#######
######....######
#####......#####
####........####
###..........###
##I..........I##
##............##
##.............x
##.....@.......x
##............##
##I..........I##
###..........###
####........####
#####......#####
################
################
