################
####..........##
####..........##
##........######
##........######
##........######
##........######
##.........T...x
##.........T...x
######.....T..##
######........##
######........##
##............##
##..........####
##..........####
################
