################
##............##
###..........###
####........####
#####......#####
######....######
#######..#######
#I.............x
#I.............x
#######..#######
#######..#######
#######..#######
#######..#######
#######..#######
#######..#######
#######xx#######
