#######xx#######
#S#####..#####S#
###I........I###
##............##
##............##
##............##
##............##
x......E.......x
x..............x
##............##
##............##
##............##
##............##
###I........I###
#S#####..#####S#
#######xx#######
