#######xx#######
#..............#
#..............#
#..............#
#..............#
#..............#
#..............#
x..............#
x..............#
#..............#
#..............#
#..............#
#..............#
#..............#
#..............#
#######xx#######
