#######xx#######
#SSSS#I..I#SSSS#
#S###......###S#
#S#..........#S#
#S#..........#S#
##............##
#I............I#
x..............x
x..............x
#I............I#
##...........###
#S#..........#S#
#S#..........#S#
#S############S#
#SSSSSSSSSSSSSS#
################
