################
###..........###
#.##........##.#
#..####II####..#
#.......T......#
#.......T......#
#.....####.....#
x.....####.....x
x.....####.....x
#.....####.....#
#..............#
#..............#
#..####II####..#
#.##........##.#
###..........###
################
