################
################
#S............S#
#..............#
#..............#
#..##########..#
#..#I......I#..#
x..#........#..x
x..#I......I#..x
#..##########..#
#..............#
#..............#
#..............#
#S............S#
######....######
#######xx#######
