#######xx#######
######....######
#####......#####
####S......S####
#I............I#
#..............#
#..............#
#####..........x
#####..........x
#..............#
#..............#
#I............I#
####S......S####
#####......#####
#######..#######
################
