################
######....######
#####......#####
####........####
###..........###
##I..........I##
##............##
x..............#
x..............#
##............##
##I..........I##
###..........###
####........####
#####......#####
######....######
#######xx#######
