#######xx#######
##..##I..I##..##
#.##.#....#.##.#
#.##.#....#.##.#
##..##....##..##
######....######
#I............I#
x.............##
x.............##
#I............I#
######....######
##..##....##..##
#.##.#....#.##.#
#.##.#....#.##.#
##..##I..I##..##
#######xx#######
