################
################
####........####
####........####
###I........I###
##............##
##.............#
##.....##..S...x
##.....##..S...x
##.............#
##............##
###I........I###
####...SS...####
####........####
####........####
#######xx#######
