#######xx#######
#.....#..#.....#
#.....#..#.....#
#.....#..#.....#
#######..#######
#S............S#
#..............#
#.....I..I.....#
#.....I..I.....#
#..............#
#S............S#
#######..#######
#.....#..#.....#
#.....#..#.....#
#.....#..#.....#
#######xx#######
