#######xx#######
####..........##
####..........##
##I.......######
##........######
##........######
##........######
x..............x
x..............x
######........##
######........##
######........##
##...........I##
##..........####
##..........####
################
