#######QQ#######
######....######
#####......#####
####S......S####
#I............I#
#..............#
#..............#
x......II......#
x......II......#
#..............#
#..............#
#I............I#
####S......S####
#####......#####
######....######
################
