################
###..........###
#.##........##.#
#..####II####..#
#..............#
#..............#
#.....####.....#
#.....####.....#
#.....####.....#
#.....####.....#
#..............#
#..............#
#..####..####..#
#.##........##.#
###..........###
#######xx#######
