#################QQ#
#..xx..xx..xx..#...#
#..xx..xx..xx..#...#
#####xx##xx##xx#xxx#
#####xx##xx##xx#xxx#
#.Txx..##..xxxx#...#
#.Txx..##..xx..#T..#
#####xx######xx#.xx#
#####xx######xx##xx#
#..xx..xx..xx..xx..#
#..xx..xx..xx..xx..#
####################


#######
      #
      
### ###

      #
#######



