######
#....#
x....x
x....x
#....#
######
