#xx#####
#......#
#......#
#......#
#......#
#......#
#......#
########
