########
#......#
#......#
#......#
#......#
#......#
#......#
#xx#####
