#####xx#
#......#
#......#
#......#
#......#
x......#
x......#
########
