################
#......#.......#
#......#.......#
#......#...I...#
#......#.......#
#......#.......#
#..............#
#..............x
#..............x
#..............#
#......#.......#
#......#.......#
#......#.......#
#......#.......#
#......#.......#
##xx############
