################
#......#.......#
#......#.......#
#......#.......#
#......#.......#
#......#.......#
#..............#
x..............x
x..............x
#..............#
#......#.......#
#......#.......#
#......#.......#
#......#.......#
#......#.......#
################
