################
#..............#
#..............#
#..............#
#..............#
#..............#
#..............#
x..............#
x..............#
#..............#
#..............#
#..............#
#..............#
#...........@..#
#..............#
#######xx#######
