######xx########
#..............#
#..............#
#..............#
#..............#
#..............#
#..............#
x..............#
x..............#
#..............#
#..............#
#..............#
#..............#
#..............#
#..............#
################
