################
#..............#
#..............#
#..............#
#..............#
#..............#
#..............#
x..........E...x
x..............x
#..............#
#..............#
#..............#
#..............#
#..............#
#..............#
################
