#######xx#######
#S............S#
#..............#
#..............#
#..............#
#..............#
#..............#
x..............#
x......I.......#
#..............#
#..............#
#..............#
#..............#
#..............#
#S............S#
################
