##xx############
#..............#
#..............#
#..............#
#..............#
#......T.......#
#..............#
Q......T.......x
Q..............x
#......T.......#
#..............#
#..............#
#..............#
#..............#
#..............#
################
