#xx#####
#......x
#......x
#......#
#......#
x......#
x......#
#####xx#
