########
#......#
#......#
#......#
#......#
#......#
#......#
#xx#xx##
