#xx##xx#
#......#
#......#
#......#
#......#
#......#
#......#
#xx#xx##
