############
#...........
#...........
#...........
#...........
x@.........x
#...........
#...........
#...........
#...........
#...........
############
