############
#...........
#...........
#...........
#...........
x...........
#...........
#...........
#...........
#..........Q
#...........
############
