########
#......#
#......#
#......#
#......#
x......#
x......#
###xx###
