###xx###
#......#
#......#
#......#
#......#
#......x
#......x
########
