########
x......#
x......#
#......#
#......#
#......x
#......x
########
