########
#@.....#
#......#
#......#
#......#
#......x
#......x
########
