########
##....##
#.#..#.#
#..##..#
#..##..#
#.#..#.#
##....##
########
