########
#..##..#
#..##..#
########
########
x..##..#
x..##..#
########
