########
x......#
x......#
#......#
#......#
#......#
#......#
########
