########
#......x
#......x
#......#
#......#
#......#
#......#
########
