########
#......#
#......#
#......#
#......#
#...T..x
#......x
########
