#####xx#
#......#
#......#
#......#
#......#
#......#
#......#
########
