########
#......#
#......#
#......#
#......#
#......#
#......#
#####xx#
