########
#......#
#......#
#......#
#......#
x......x
x......x
########
