#xx##xx#
#......#
#......#
#......#
#......#
#......#
#......#
########
